!!ATOK_TANGO_TEXT_HEADER_1
あまな	甘奈	固有人名
おおさきあまな	大崎甘奈	固有人名
おおさきてんか	大崎甜花	固有人名
かざのひおり	風野灯織	固有人名
かほ	果穂	固有人名
きりこ	霧子	固有人名
くわやまちゆき	桑山千雪	固有人名
こがね	恋鐘	固有人名
こみやかほ	小宮果穂	固有人名
さいじょうじゅり	西城樹里	固有人名
さくや	咲耶	固有人名
さくらぎまの	櫻木真乃	固有人名
しらせさくや	白瀬咲耶	固有人名
じゅり	樹里	固有人名
そのだちよこ	園田智代子	固有人名
たなかまみみ	田中摩美々	固有人名
ちゆき	千雪	固有人名
ちよこ	智代子	固有人名
つきおかこがね	月岡恋鐘	固有人名
てんか	甜花	固有人名
はちみやめぐる	八宮めぐる	固有人名
ひおり	灯織	固有人名
まの	真乃	固有人名
まみみ	摩美々	固有人名
みつみねゆいか	三峰結華	固有人名
めぐる	めぐる	固有人名
もりのりんぜ	杜野凛世	固有人名
ゆいか	結華	固有人名
ゆうこくきりこ	幽谷霧子	固有人名
りんぜ	凛世	固有人名
