!!ATOK_TANGO_TEXT_HEADER_1
あいかわちなつ	相川千夏	固有人名
あいこ	藍子	固有人名
あいざわさや	会沢紗弥	固有人名
あいのなぎさ	愛野渚	固有人名
あいはらことみ	藍原ことみ	固有人名
あいはらゆきの	相原雪乃	固有人名
あいばゆみ	相葉夕美	固有人名
あいり	愛梨	固有人名
あおい	葵	固有人名
あおきしき	青木志貴	固有人名
あおきるりこ	青木瑠璃子	固有人名
あかぎみりあ	赤城みりあ	固有人名
あかさきちなつ	赤﨑千夏	固有人名
あかにしえりか	赤西瑛梨華	固有人名
あかね	茜	固有人名
あき	亜季	固有人名
あきは	晶葉	固有人名
あこ	亜子	固有人名
あさいあやか	朝井彩加	固有人名
あさのふうか	浅野風香	固有人名
あさりななみ	浅利七海	固有人名
あすか	飛鳥	固有人名
あつみ	愛海	固有人名
あなすたしあ	アナスタシア	固有人名
あべなな	安部菜々	固有人名
あやか	彩華	固有人名
あやせほのか	綾瀬穂乃香	固有人名
あゆな	愛結奈	固有人名
あらきひな	荒木比奈	固有人名
ありうらかんな	有浦柑奈	固有人名
ありさ	亜里沙	固有人名
あんざいみやこ	安斎都	固有人名
あんず	杏	固有人名
いいだゆうこ	飯田友子	固有人名
いう゛さんたくろーす	イヴ・サンタクロース	固有人名
いがらしきょうこ	五十嵐響子	固有人名
いがらしひろみ	五十嵐裕美	固有人名
いけぶくろあきは	池袋晶葉	固有人名
いじゅういんめぐみ	伊集院惠	固有人名
いずみ	泉	固有人名
いちのせしき	一ノ瀬志希	固有人名
いちはらにな	市原仁奈	固有人名
いぶき	伊吹	固有人名
いまいあさか	今井麻夏	固有人名
いまいかな	今井加奈	固有人名
いむらせつな	井村雪菜	固有人名
うえさかすみれ	上坂すみれ	固有人名
うえだすずほ	上田鈴帆	固有人名
うじいえむつみ	氏家むつみ	固有人名
うちだまあや	内田真礼	固有人名
うづき	卯月	固有人名
うみ	海	固有人名
うめきおとは	梅木音葉	固有人名
えがみつばき	江上椿	固有人名
えとうみさき	衛藤美紗希	固有人名
えびはらなほ	海老原菜帆	固有人名
えま	恵磨	固有人名
えみ	笑美	固有人名
えりか	瑛梨華	固有人名
おいかわしずく	及川雫	固有人名
おうさきちよ	桜咲千依	固有人名
おおいしいずみ	大石泉	固有人名
おおぞらなおみ	大空直美	固有人名
おおたゆう	太田優	固有人名
おおつきゆい	大槻唯	固有人名
おおつぼゆか	大坪由佳	固有人名
おおにしゆりこ	大西由里子	固有人名
おおぬまくるみ	大沼くるみ	固有人名
おおはしあやか	大橋彩香	固有人名
おおはらみちる	大原みちる	固有人名
おかざきやすは	岡崎泰葉	固有人名
おがたちえり	緒方智絵里	固有人名
おくやまさおり	奥山沙織	固有人名
おとくらゆうき	乙倉悠貴	固有人名
おとは	音葉	固有人名
かい	櫂	固有人名
かえで	楓	固有人名
かおる	薫	固有人名
かこ	茄子	固有人名
かたぎりさなえ	片桐早苗	固有人名
かな	加奈	固有人名
かなこ	かな子	固有人名
かなで	奏	固有人名
かねこまゆみ	金子真由美	固有人名
かねこゆうき	金子有希	固有人名
かみじょうはるな	上条春菜	固有人名
かみやなお	神谷奈緒	固有人名
かやまみさ	嘉山未紗	固有人名
かりん	歌鈴	固有人名
かれん	加蓮	固有人名
かわしまみずき	川島瑞樹	固有人名
かんざきらんこ	神崎蘭子	固有人名
かんな	柑奈	固有人名
きしべあやか	岸辺彩華	固有人名
きたがわまひろ	北川真尋	固有人名
きたひなこ	喜多日菜子	固有人名
きたみゆず	喜多見柚	固有人名
きばまなみ	木場真奈美	固有人名
きむらじゅり	木村珠莉	固有人名
きむらなつき	木村夏樹	固有人名
きゃしーぐらはむ	キャシー・グラハム	固有人名
きょうこ	響子	固有人名
きよみ	清美	固有人名
きよら	清良	固有人名
きりのあや	桐野アヤ	固有人名
きりゅうつかさ	桐生つかさ	固有人名
くさかべわかば	日下部若葉	固有人名
くどうしのぶ	工藤忍	固有人名
くのみさき	久野美咲	固有人名
くみこ	久美子	固有人名
くらりす	クラリス	固有人名
くりはらねね	栗原ネネ	固有人名
くろかわちあき	黒川千秋	固有人名
くろさわともよ	黒沢ともよ	固有人名
けいと	ケイト	固有人名
こいちまこと	小市眞琴	固有人名
こうめ	小梅	固有人名
こがこはる	古賀小春	固有人名
こしみずさちこ	輿水幸子	固有人名
こせきれいな	小関麗奈	固有人名
ことか	琴歌	固有人名
こはる	小春	固有人名
こばやかわさえ	小早川紗枝	固有人名
こひなたみほ	小日向美穂	固有人名
こまついぶき	小松伊吹	固有人名
こむろちなみ	小室千奈美	固有人名
さいおんじことか	西園寺琴歌	固有人名
さいとうようこ	斉藤洋子	固有人名
さえ	紗枝	固有人名
さえじまきよみ	冴島清美	固有人名
さおり	沙織	固有人名
さかきばらさとみ	榊原里美	固有人名
さき	沙紀	固有人名
さぎさわふみか	鷺沢文香	固有人名
さくままゆ	佐久間まゆ	固有人名
さくらいももか	櫻井桃華	固有人名
ささきちえ	佐々木千枝	固有人名
さじょうゆきみ	佐城雪美	固有人名
さちこ	幸子	固有人名
さとうあみな	佐藤亜美菜	固有人名
さとうしん	佐藤心	固有人名
さとうりな	佐藤利奈	固有人名
さとみ	里美	固有人名
さな	紗南	固有人名
さなえ	早苗	固有人名
さや	早耶	固有人名
さりな	沙理奈	固有人名
さわだまりな	沢田麻理菜	固有人名
ざいぜんときこ	財前時子	固有人名
しいなのりこ	椎名法子	固有人名
しおみしゅうこ	塩見周子	固有人名
しおり	詩織	固有人名
しき	志希	固有人名
しずく	雫	固有人名
しの	志乃	固有人名
しのはられい	篠原礼	固有人名
しのぶ	忍	固有人名
しぶやりん	渋谷凛	固有人名
しほ	志保	固有人名
しまむらうづき	島村卯月	固有人名
しもじしの	下地紫野	固有人名
しゅうこ	周子	固有人名
しゅとうあおい	首藤葵	固有人名
しょうこ	輝子	固有人名
しらぎくほたる	白菊ほたる	固有人名
しらさかこうめ	白坂小梅	固有人名
しん	心	固有人名
じょうがさきみか	城ヶ崎美嘉	固有人名
じょうがさきりか	城ヶ崎莉嘉	固有人名
すぎさかうみ	杉坂海	固有人名
すざきあや	洲崎綾	固有人名
すずきえり	鈴木絵理	固有人名
すずきみのり	鈴木みのり	固有人名
すずほ	鈴帆	固有人名
すずみやせいか	涼宮星花	固有人名
せいか	星花	固有人名
せいら	聖來	固有人名
せきひろみ	関裕美	固有人名
せつな	雪菜	固有人名
せなしおり	瀬名詩織	固有人名
せんざきえま	仙崎恵磨	固有人名
そうまなつみ	相馬夏美	固有人名
たかがきかえで	高垣楓	固有人名
たかだゆうき	高田憂希	固有人名
たかのあさみ	髙野麻美	固有人名
たかはしかりん	高橋花林	固有人名
たかはしれいこ	高橋礼子	固有人名
たかふじかこ	鷹富士茄子	固有人名
たかみねのあ	高峯のあ	固有人名
たかもりあいこ	高森藍子	固有人名
たかもりなつみ	高森奈津美	固有人名
たくみ	拓海	固有人名
たくみやすあき	内匠靖明	固有人名
たけうちしゅんすけ	武内駿輔	固有人名
たけたつあやな	竹達彩奈	固有人名
たけだらりさたご	武田羅梨沙多胡	固有人名
たざわますみ	田澤茉純	固有人名
ただりいな	多田李衣菜	固有人名
たちばなありす	橘ありす	固有人名
たちばなりか	立花理香	固有人名
たなかあつこ	田中敦子	固有人名
たなべるい	田辺留依	固有人名
たねざきあつみ	種﨑敦美	固有人名
たまみ	珠美	固有人名
だてありさ	伊達朱里紗	固有人名
ちあき	千秋	固有人名
ちえ	千枝	固有人名
ちえり	智絵里	固有人名
ちか	千佳	固有人名
ちすがはるか	千菅春香	固有人名
ちづる	千鶴	固有人名
ちなつ	千夏	固有人名
ちなみ	千奈美	固有人名
つきみやみやび	月宮雅	固有人名
つだみなみ	津田美波	固有人名
つちやあこ	土屋亜子	固有人名
つばき	椿	固有人名
てるいはるか	照井春佳	固有人名
とうこ	瞳子	固有人名
とうごうあい	東郷あい	固有人名
とうやまなお	東山奈央	固有人名
ときこ	時子	固有人名
とときあいり	十時愛梨	固有人名
とまるちよ	都丸ちよ	固有人名
とも	朋	固有人名
ともえ	巴	固有人名
ともか	智香	固有人名
どうみょうじかりん	道明寺歌鈴	固有人名
なお	奈緒	固有人名
なかしまゆき	中島由貴	固有人名
なかのゆか	中野有香	固有人名
ながしまみな	長島光那	固有人名
ながとみはすみ	長富蓮実	固有人名
なぎさ	渚	固有人名
なたーりあ	ナターリア	固有人名
なつき	夏樹	固有人名
なつみ	夏美	固有人名
なな	菜々	固有人名
ななみ	七海	固有人名
なほ	菜帆	固有人名
なみきめいこ	並木芽衣子	固有人名
なるみやゆめ	成宮由愛	固有人名
なんじょうひかる	南条光	固有人名
なんばえみ	難波笑美	固有人名
にしかわほなみ	西川保奈美	固有人名
にしじまかい	西島櫂	固有人名
にったひより	新田ひより	固有人名
にったみなみ	新田美波	固有人名
にな	仁奈	固有人名
にのみやあすか	二宮飛鳥	固有人名
にわひとみ	丹羽仁美	固有人名
のの	乃々	固有人名
ののむらそら	野々村そら	固有人名
のりこ	法子	固有人名
はじめ	肇	固有人名
はすみ	蓮実	固有人名
はっとりとうこ	服部瞳子	固有人名
はないみはる	花井美春	固有人名
はなもりゆみり	花守ゆみり	固有人名
はまかわあゆな	浜川愛結奈	固有人名
はまぐちあやめ	浜口あやめ	固有人名
はやさかみれい	早坂美玲	固有人名
はやみかなで	速水奏	固有人名
はやみさおり	早見沙織	固有人名
はらさゆり	原紗友里	固有人名
はらださやか	原田彩楓	固有人名
はらだひとみ	原田ひとみ	固有人名
はらだみよ	原田美世	固有人名
はらゆうこ	原優子	固有人名
はる	晴	固有人名
はるせなつみ	春瀬なつみ	固有人名
はるな	春菜	固有人名
はるのななみ	春野ななみ	固有人名
ひいらぎしの	柊志乃	固有人名
ひかる	光	固有人名
ひじり	聖	固有人名
ひとみ	仁美	固有人名
ひな	比奈	固有人名
ひなこ	日菜子	固有人名
ひのあかね	日野茜	固有人名
ひめかわゆき	姫川友紀	固有人名
ひょうどうれな	兵藤レナ	固有人名
ひろみ	裕美	固有人名
ふうか	風香	固有人名
ふぇいふぇい	菲菲	固有人名
ふくはらあやか	福原綾香	固有人名
ふくやままい	福山舞	固有人名
ふじいとも	藤居朋	固有人名
ふじたあかね	藤田茜	固有人名
ふじもとあやか	藤本彩花	固有人名
ふじもとりな	藤本里奈	固有人名
ふじわらはじめ	藤原肇	固有人名
ふたばあんず	双葉杏	固有人名
ふちがみまい	渕上舞	固有人名
ふみか	文香	固有人名
ふるさわよりこ	古澤頼子	固有人名
へれん	ヘレン	固有人名
ほうじょうかれん	北条加蓮	固有人名
ほししょうこ	星輝子	固有人名
ほなみ	保奈美	固有人名
ほのか	穂乃香	固有人名
ほりゆうこ	堀裕子	固有人名
ほんだみお	本田未央	固有人名
まい	舞	固有人名
まえかわみく	前川みく	固有人名
まきのゆい	牧野由依	固有人名
まきはらしほ	槙原志保	固有人名
まついえりこ	松井恵理子	固有人名
まつおちづる	松尾千鶴	固有人名
まつざきれい	松嵜麗	固有人名
まつださつみ	松田颯水	固有人名
まつながりょう	松永涼	固有人名
まつばらさや	松原早耶	固有人名
まつもとさりな	松本沙理奈	固有人名
まつやまくみこ	松山久美子	固有人名
まとばりさ	的場梨沙	固有人名
まなかみさと	間中美里	固有人名
まなべいつき	真鍋いつき	固有人名
まなみ	真奈美	固有人名
まひろ	真尋	固有人名
まりな	麻理菜	固有人名
みう	美羽	固有人名
みお	未央	固有人名
みか	美嘉	固有人名
みさき	美紗希	固有人名
みさと	美里	固有人名
みずき	瑞樹	固有人名
みずきせいら	水木聖來	固有人名
みずのみどり	水野翠	固有人名
みずもとゆかり	水本ゆかり	固有人名
みどり	翠	固有人名
みなみ	美波	固有人名
みふねみゆ	三船美優	固有人名
みほ	美穂	固有人名
みむらかなこ	三村かな子	固有人名
みやけまりえ	三宅麻理恵	固有人名
みやこ	都	固有人名
みやび	雅	固有人名
みやもとふれでりか	宮本フレデリカ	固有人名
みゆ	美優	固有人名
みゆき	美由紀	固有人名
みよ	美世	固有人名
みよしさな	三好紗南	固有人名
みれい	美玲	固有人名
むかいたくみ	向井拓海	固有人名
むなかたあつみ	棟方愛海	固有人名
むらかみともえ	村上巴	固有人名
むらなかとも	村中知	固有人名
むらまつさくら	村松さくら	固有人名
めありーこくらん	メアリー・コクラン	固有人名
めいこ	芽衣子	固有人名
めぐみ	惠	固有人名
もちだありさ	持田亜里沙	固有人名
もちづきひじり	望月聖	固有人名
ももいあずき	桃井あずき	固有人名
ももか	桃華	固有人名
もりくぼのの	森久保乃々	固有人名
もりのまこ	杜野まこ	固有人名
もろぼしきらり	諸星きらり	固有人名
やおふぇいふぇい	楊菲菲	固有人名
やがみまきの	八神マキノ	固有人名
やぐちみう	矢口美羽	固有人名
やすのきよの	安野希世乃	固有人名
やすは	泰葉	固有人名
やなぎきよら	柳清良	固有人名
やなせみゆき	柳瀬美由紀	固有人名
やましたななみ	山下七海	固有人名
やまとあき	大和亜季	固有人名
やまもとのぞみ	山本希望	固有人名
ゆい	唯	固有人名
ゆう	優	固有人名
ゆうき	悠貴	固有人名
ゆうきはる	結城晴	固有人名
ゆうこ	裕子	固有人名
ゆか	有香	固有人名
ゆき	友紀	固有人名
ゆきの	雪乃	固有人名
ゆきみ	雪美	固有人名
ゆさこずえ	遊佐こずえ	固有人名
ゆず	柚	固有人名
ゆみ	夕美	固有人名
ゆめ	由愛	固有人名
ゆりこ	由里子	固有人名
ようこ	洋子	固有人名
よこやまちか	横山千佳	固有人名
よしおかさき	吉岡沙紀	固有人名
よしの	芳乃	固有人名
よしむらはるか	佳村はるか	固有人名
よないゆうき	米内佑希	固有人名
よりこ	頼子	固有人名
よりたよしの	依田芳乃	固有人名
らいら	ライラ	固有人名
らんこ	蘭子	固有人名
りいな	李衣菜	固有人名
りか	莉嘉	固有人名
りさ	梨沙	固有人名
りな	里奈	固有人名
りゅうざきかおる	龍崎薫	固有人名
りょう	涼	固有人名
りん	凛	固有人名
るみ	留美	固有人名
れい	礼	固有人名
れいこ	礼子	固有人名
れいな	麗奈	固有人名
わかば	若葉	固有人名
わかばやしともか	若林智香	固有人名
わきあずみ	和氣あず未	固有人名
わきやまたまみ	脇山珠美	固有人名
わくいるみ	和久井留美	固有人名
