!!ATOK_TANGO_TEXT_HEADER_1
あいみ	愛美	固有人名
あかね	茜	固有人名
あきづきりつこ	秋月律子	固有人名
あさくらあずみ	浅倉杏美	固有人名
あさくらもも	麻倉もも	固有人名
あべりか	阿部里果	固有人名
あまみはるか	天海春香	固有人名
あまみやそら	雨宮天	固有人名
あみ	亜美	固有人名
あゆむ	歩	固有人名
ありさ	亜利沙	固有人名
あんな	杏奈	固有人名
いおり	伊織	固有人名
いく	育	固有人名
いとうみく	伊藤美来	固有人名
いながわえり	稲川英里	固有人名
いぶきつばさ	伊吹翼	固有人名
いまいあさみ	今井麻美	固有人名
うえだれいな	上田麗奈	固有人名
うみ	海美	固有人名
えみりーすちゅあーと	エミリースチュアート	固有人名
おおがみたまき	大神環	固有人名
おおぜきえり	大関英里	固有人名
おがさわらさき	小笠原早紀	固有人名
かおり	歌織	固有人名
かくもとあすか	角元明日香	固有人名
かすがみらい	春日未来	固有人名
かな	可奈	固有人名
かはらゆう	郁原ゆう	固有人名
かれん	可憐	固有人名
がなはひびき	我那覇響	固有人名
きくちまこと	菊池真	固有人名
きさらぎちはや	如月千早	固有人名
きたかみれいか	北上麗花	固有人名
きたざわしほ	北沢志保	固有人名
きどいぶき	木戸衣吹	固有人名
きのしたひなた	木下ひなた	固有人名
きりたにちょうちょ	桐谷蝶々	固有人名
くぎみやりえ	釘宮理恵	固有人名
こいわいことり	小岩井ことり	固有人名
こうさかうみ	高坂海美	固有人名
こうりありさ	香里有佐	固有人名
ことは	琴葉	固有人名
こまがたゆり	駒形友梨	固有人名
こんどうゆい	近藤唯	固有人名
さいとうゆか	斎藤佑圭	固有人名
さくらもりかおり	桜守歌織	固有人名
さたけみなこ	佐竹美奈子	固有人名
さよこ	紗代子	固有人名
しじょうたかね	四条貴音	固有人名
しずか	静香	固有人名
しのみやかれん	篠宮可憐	固有人名
しほ	志保	固有人名
しまばらえれな	島原エレナ	固有人名
しもだあさみ	下田麻美	固有人名
しらいしつむぎ	白石紬	固有人名
じゅりあ	ジュリア	固有人名
すえがらりえ	末柄里恵	固有人名
すおうももこ	周防桃子	固有人名
すばる	昴	固有人名
すわあやか	諏訪彩花	固有人名
せりか	星梨花	固有人名
たかつきやよい	高槻やよい	固有人名
たかね	貴音	固有人名
たかはしちあき	たかはし智秋	固有人名
たかはしみなみ	高橋未奈美	固有人名
たかやまさよこ	高山紗代子	固有人名
たどころあずさ	田所あずさ	固有人名
たなかことは	田中琴葉	固有人名
たねだりさ	種田梨沙	固有人名
たまき	環	固有人名
たむらなお	田村奈央	固有人名
ちづる	千鶴	固有人名
ちはや	千早	固有人名
つばさ	翼	固有人名
つむぎ	紬	固有人名
てんくうばしともか	天空橋朋花	固有人名
とくがわまつり	徳川まつり	固有人名
ところめぐみ	所恵美	固有人名
とだめぐみ	戸田めぐみ	固有人名
ともか	朋花	固有人名
とよかわふうか	豊川風花	固有人名
なお	奈緒	固有人名
なかたにいく	中谷育	固有人名
なかむらあつき	中村温姫	固有人名
なかむらえりこ	中村繪里子	固有人名
ながよしすばる	永吉昴	固有人名
なつかわしいな	夏川椎菜	固有人名
ななおゆりこ	七尾百合子	固有人名
にかいどうちづる	二階堂千鶴	固有人名
にごまやこ	仁後真耶子	固有人名
ぬまくらまなみ	沼倉愛美	固有人名
ののはらあかね	野々原茜	固有人名
のむらかなこ	野村香菜子	固有人名
のりこ	のり子	固有人名
はぎわらゆきほ	萩原雪歩	固有人名
はこざきせりか	箱崎星梨花	固有人名
はせがわあきこ	長谷川明子	固有人名
はまさきなな	浜崎奈々	固有人名
はらしまあかり	原嶋あかり	固有人名
はらゆみ	原由実	固有人名
はるか	春香	固有人名
はんだろこ	伴田路子	固有人名
ばばこのみ	馬場このみ	固有人名
ひびき	響	固有人名
ひらたひろみ	平田宏美	固有人名
ひらやまえみ	平山笑美	固有人名
ふうか	風花	固有人名
ふくだのりこ	福田のり子	固有人名
ふじいゆきよ	藤井ゆきよ	固有人名
ふたみあみ	双海亜美	固有人名
ふたみまみ	双海真美	固有人名
ほしいみき	星井美希	固有人名
まいはまあゆむ	舞浜歩	固有人名
まかべみずき	真壁瑞希	固有人名
まこと	真	固有人名
まつだありさ	松田亜利沙	固有人名
まみ	真美	固有人名
みうらあずさ	三浦あずさ	固有人名
みき	美希	固有人名
みずき	瑞希	固有人名
みなこ	美奈子	固有人名
みなせいおり	水瀬伊織	固有人名
みなみさき	南早紀	固有人名
みや	美也	固有人名
みやおみや	宮尾美也	固有人名
みらい	未来	固有人名
むらかわりえ	村川梨衣	固有人名
めぐみ	恵美	固有人名
もがみしずか	最上静香	固有人名
もちづきあんな	望月杏奈	固有人名
ももこ	桃子	固有人名
ももせりお	百瀬莉緒	固有人名
やぶきかな	矢吹可奈	固有人名
やまぐちりかこ	山口立花子	固有人名
やまざきはるか	山崎はるか	固有人名
ゆきほ	雪歩	固有人名
ゆりこ	百合子	固有人名
よこやまなお	横山奈緒	固有人名
りお	莉緒	固有人名
りつこ	律子	固有人名
れいか	麗花	固有人名
ろこ	路子	固有人名
わかばやしなおみ	若林直美	固有人名
わたなべけいこ	渡部恵子	固有人名
わたなべゆい	渡部優衣	固有人名
